
NO ./path_to_the_north_texture

SO ./path_to_the_south_texture

WE ./path_to_the_west_texture

EA ./path_to_the_east_texture						





F 255,255,0





C 225,30,0



11111111111111111111111111
11  111S101100000001010100111
11  1111110000000111111111
111111111111111111111111






