NO wall/NO.xpm

SO wall/SO.xpm

WE wall/WE.xpm

EA wall/EA.xpm





F 155,155,155





C 100,100,100




1111111111
100000000111
122333000001
100000000001
100000000111
10000000N1
1111111111