
NO ./path_to_the_north_texture

SO ./path_to_the_south_texture

WE ./path_to_the_west_texture

EA ./path_to_the_east_texture





F 255,255,0





C 225,30,0





1111111111111111111
1010000021
1010000011
1S11
111111
