
NO wall/NO.xpm

SO wall/SO.xpm

WE wall/WE.xpm

EA wall/EA.xpm





F 155,155,155





C 100,100,100





1111111111111111111
1010000021
1010000011
1S11
111111
